31,60,51,71,71,31,63,71,71,96,63,43,71,52,71,71
31,42,94,71,43,71,97,71,71,71,51,71,71,40,63,51
63,71,00,02,02,02,02,02,02,02,01,71,42,71,63,71
30,33,03,20,21,20,22,20,23,20,13,94,71,71,71,40
71,71,03,20,20,20,20,20,20,20,13,31,71,73,71,42
61,33,03,20,20,20,20,20,20,20,13,63,71,71,71,30
51,71,03,20,20,20,20,20,20,20,13,95,52,71,42,71
71,71,10,12,12,12,12,12,12,12,11,60,41,71,71,61
52,71,60,98,43,97,71,63,62,98,71,43,33,71,60,71